时间,上海新增确诊病例,上海无症状感染者,深圳新增确诊病例,深圳无症状感染者,广东新增确诊病例,广东无症状感染者,新增确诊人数,新增死亡人数,新增疑似人数,新增治愈人数,现有确诊人数,累计治愈人数,累计死亡人,累计确诊人数,现有疑似人数,累计密切接触者,年份
3.2,0,0,0,0,0,0,125,31,129,2742,30004,47204,2943,80151,587,664899,2020
3.3,0,0,0,0,0,0,119,38,143,2652,27433,49856,2981,80270,520,666397,2020
3.4,0,0,0,0,0,0,139,31,143,2189,25352,52045,3012,80409,522,669025,2020
3.5,0,0,0,0,0,0,143,30,102,1681,23784,53726,3042,80552,482,670854,2020
3.6,0,0,0,0,0,0,99,28,99,1678,22177,55404,3070,80651,502,672458,2020
3.7,0,0,0,0,0,0,44,27,84,1661,20533,57065,3097,80695,458,674038,2020
3.8,0,0,0,0,0,0,40,22,60,1535,19016,58600,3119,80735,421,674760,2020
3.9,0,0,0,0,0,0,19,17,36,1297,17721,59897,3136,80754,349,675338,2020
3.10,0,0,0,0,0,0,24,22,31,1578,16145,61475,3158,80778,285,675886,2020
3.11,0,0,0,0,0,0,15,11,33,1318,14831,62793,3169,80793,253,677243,2020
3.12,0,0,0,0,0,0,8,7,33,1318,13526,64111,3176,80813,147,678088,2020
3.13,0,0,0,0,0,0,11,13,17,1430,12094,65541,3189,80824,115,678935,2020
3.14,0,0,0,0,0,0,20,10,39,1370,10734,66911,3199,80844,113,679759,2020
3.15,0,0,0,0,0,0,16,14,41,838,9898,67749,3213,80860,134,680462,2020
3.16,0,0,0,0,0,0,21,13,45,930,8976,68679,3226,80881,128,681404,2020
3.17,0,0,0,0,0,0,13,11,21,922,8056,69601,3237,80894,119,682327,2020
3.18,0,0,0,0,0,0,34,8,23,819,7263,70420,3245,80928,105,683281,2020
3.19,0,0,0,0,0,0,39,3,31,730,6569,71150,3248,80967,104,684331,2020
3.20,0,0,0,0,0,0,41,7,36,590,6013,71740,3255,81008,106,685866,2020
3.21,0,0,0,0,0,0,46,6,45,504,5549,72244,3261,81054,118,687680,2020
3.22,0,0,0,0,0,0,39,9,47,459,5120,72703,3270,81093,136,688993,2020
3.23,0,0,0,0,0,0,78,7,35,456,4735,73159,3277,81171,132,691185,2020
3.24,0,0,0,0,0,0,47,4,33,491,4287,73650,3281,81218,134,693223,2020
3.25,0,0,0,0,0,0,67,6,58,401,3947,74051,3287,81285,159,695305,2020
3.26,0,0,0,0,0,0,55,5,49,537,3460,74588,3292,81340,189,697470,2020
3.27,0,0,0,0,0,0,54,3,29,383,3128,74971,3295,81394,184,699396,2020
3.28,0,0,0,0,0,0,45,5,28,477,2691,75448,3300,81439,174,701884,2020
3.29,0,0,0,0,0,0,31,4,17,322,2396,75770,3304,81470,168,704190,2020
3.30,0,0,0,0,0,0,48,1,44,282,2161,76052,3305,81518,183,706017,2020
3.31,1,0,0,0,1,0,36,7,26,186,2004,76238,3312,81554,172,707913,2020
4.1,0,0,0,0,0,0,35,6,20,170,1863,76408,3318,81589,153,709570,2020
4.2,0,0,0,0,1,0,31,4,12,163,1727,76571,3322,81620,135,710985,2020
4.3,0,0,0,0,0,0,19,4,11,180,1562,76751,3326,81639,114,712088,2020
4.4,0,0,0,0,5,0,30,3,11,213,1376,76964,3329,81669,107,713110,2020
4.5,0,0,0,0,1,0,39,1,10,114,1299,77078,3331,81708,88,713988,2020
4.6,0,0,0,0,0,0,32,0,12,89,1242,77167,3331,81740,0,714720,2020
4.7,1,0,0,0,1,0,62,2,12,112,1190,77279,3333,81802,0,715854,2020
4.8,0,0,0,0,2,0,63,2,17,91,1160,77370,3335,81865,0,716889,2020
4.9,1,0,0,0,3,0,42,1,3,85,1116,77455,3336,81907,0,717378,2020
4.10,2,0,0,0,3,0,46,3,8,70,1089,77525,3339,81953,0,718050,2020
4.11,43,0,0,0,0,0,99,0,49,50,1138,77575,3339,82052,0,718881,2020
4.12,2,0,0,0,3,0,108,2,6,88,1156,77663,3341,82160,0,719908,2020
4.13,2,0,0,0,3,0,89,0,3,75,1170,77738,3341,82249,0,720544,2020
4.14,4,0,0,0,2,0,46,1,11,78,1137,77816,3342,82295,0,721295,2020
4.15,3,0,0,0,5,0,46,0,4,76,1107,77892,3342,82341,0,722007,2020
4.16,0,0,0,0,5,0,26,0,3,52,1081,77944,3342,82367,0,722909,2020
4.17,3,0,0,0,2,0,27,0,5,50,1058,77029,4632,82719,0,723835,2020
4.18,0,0,0,0,1,0,16,0,2,33,1041,77062,4632,82735,0,724850,2020
4.19,2,0,0,0,0,0,12,0,2,22,1031,77084,4632,82747,0,725814,2020
4.20,0,0,0,0,1,0,11,0,3,39,1003,77123,4632,82758,0,726797,2020
4.21,0,0,0,0,0,0,30,0,3,28,1005,77151,4632,82788,0,727589,2020
4.22,0,0,0,0,1,0,10,0,0,56,959,77207,4632,82798,0,728049,2020
4.23,2,0,0,0,1,0,6,0,2,50,915,77257,4632,82804,0,728590,2020
4.24,0,0,0,0,0,0,12,0,3,89,838,77346,4632,82816,0,729287,2020
4.25,0,0,0,0,1,0,11,0,0,48,801,77394,4632,82827,0,729885,2020
4.26,0,0,0,0,0,0,3,0,5,80,723,77474,4633,82830,0,730529,2020
4.27,1,0,0,0,0,0,6,0,1,81,648,77555,4633,82836,0,731015,2020
4.28,1,0,0,0,1,0,22,0,2,23,647,77578,4633,82858,0,731910,2020
4.29,0,0,0,0,0,0,4,0,3,32,619,77610,4633,82862,0,732369,2020
4.30,0,0,0,0,0,0,12,0,3,32,599,77642,4633,82874,0,732966,2020
5.1,0,0,0,0,0,0,1,0,2,43,557,77685,4633,82875,11,733733,2020
5.2,0,0,0,0,0,0,2,0,0,28,531,77713,4633,82877,10,734281,2020
5.3,0,0,0,0,0,0,3,0,1,53,481,77766,4633,82880,3,734766,2020
5.4,0,0,0,0,0,0,1,0,0,87,395,77853,4633,82881,2,735240,2020
5.5,0,0,0,0,0,0,2,0,3,58,339,77911,4633,82883,5,735577,2020
5.6,0,0,0,0,0,0,2,0,2,46,295,77957,4633,82885,4,735737,2020
5.7,0,0,0,0,0,0,1,0,3,36,260,77993,4633,82886,6,736010,2020
5.8,0,0,0,0,0,0,1,0,2,53,208,78046,4633,82887,8,736372,2020
5.9,0,0,0,0,0,0,14,0,1,74,148,78120,4633,82901,4,736787,2020
5.10,0,0,0,0,0,0,17,0,0,24,141,78144,4633,82918,3,737127,2020
5.11,0,0,0,0,0,0,1,0,1,27,115,78171,4633,82919,3,737599,2020
5.12,0,0,0,0,0,0,7,0,1,18,104,78189,4633,82926,4,737901,2020
5.13,0,0,0,0,0,0,3,0,0,6,101,78195,4633,82929,4,738262,2020
5.14,0,0,0,0,0,0,4,0,1,14,91,78209,4633,82933,4,738691,2020
5.15,0,0,0,0,0,0,8,0,2,10,89,78219,4633,82941,3,739278,2020
5.16,1,0,0,0,0,0,5,0,2,8,86,78227,4634,82947,4,739545,2020
5.17,1,0,0,0,0,0,7,0,1,11,82,78238,4634,82954,4,740054,2020
5.18,1,0,0,0,0,0,6,0,1,3,85,78241,4634,82960,3,740428,2020
5.19,0,0,0,0,0,0,5,0,3,3,87,78244,4634,82965,7,740614,2020
5.20,0,0,0,0,0,0,2,0,1,5,84,78249,4634,82967,7,740967,2020
5.21,0,0,0,0,0,0,4,0,1,6,82,78255,4634,82971,7,741344,2020
5.22,0,0,0,0,0,0,0,0,2,3,79,78258,4634,82971,6,741696,2020
5.23,0,0,0,0,0,0,3,0,3,3,79,78261,4634,82974,9,742045,2020
5.24,0,0,0,0,0,0,11,0,0,7,83,78268,4634,82985,6,742506,2020
5.25,0,0,0,0,0,0,7,0,0,9,81,78277,4634,82992,5,743188,2020
5.26,0,0,0,0,0,0,1,0,1,3,79,78280,4634,82993,6,743586,2020
5.27,0,0,0,0,0,0,2,0,0,8,73,78288,4634,82995,5,743799,2020
5.28,0,0,0,0,0,0,0,0,0,3,70,78291,4634,82995,5,744228,2020
5.29,0,0,0,0,0,0,4,0,1,11,63,78302,4634,82999,5,744490,2020
5.30,0,0,0,0,0,0,2,0,0,2,63,78304,4634,83001,4,744693,2020
5.31,0,0,0,0,0,0,16,0,0,3,76,78307,4634,83017,3,745147,2020
6.1,0,0,0,0,0,0,5,0,0,8,73,78315,4634,83022,2,745613,2020
6.2,0,0,0,0,0,0,1,0,1,1,73,78314,4634,83021,3,745950,2020
6.3,0,0,0,0,0,0,1,0,0,5,69,78319,4634,83022,3,746084,2020
6.4,0,0,0,0,0,0,5,0,0,8,66,78327,4634,83027,2,746349,2020
6.5,0,0,0,0,0,0,3,0,1,2,67,78329,4634,83030,2,746611,2020
6.6,0,0,0,0,0,0,6,0,2,3,70,78332,4634,83036,3,746744,2020
6.7,0,0,0,0,0,0,4,0,1,9,65,78341,4634,83040,4,747066,2020
6.8,0,0,0,0,0,0,3,0,0,10,58,78351,4634,83043,1,747232,2020
6.9,0,0,0,0,0,0,3,0,1,6,55,78357,4634,83046,2,747680,2020
6.10,0,0,0,0,0,0,11,0,0,4,62,78361,4634,83057,1,750487,2020
6.11,0,0,0,0,0,0,7,0,0,4,65,78365,4634,83064,1,750674,2020
6.12,0,0,0,0,0,0,11,0,0,2,74,78367,4634,83075,1,751383,2020
6.13,1,0,0,0,0,0,57,0,1,2,129,78369,4634,83132,2,752087,2020
6.14,0,0,0,0,0,0,49,0,1,1,177,78370,4634,83181,3,752978,2020
6.15,0,0,0,0,0,0,40,0,3,7,210,78377,4634,83221,4,753836,2020
6.16,0,0,0,0,0,0,44,0,3,2,252,78379,4634,83265,7,754269,2020
6.17,0,0,0,0,0,0,28,0,3,15,265,78394,4634,83293,7,754966,2020
6.18,0,0,0,0,0,0,32,0,2,4,293,78398,4634,83325,7,755832,2020
6.19,0,0,0,0,0,0,27,0,4,12,308,78410,4634,83352,11,756223,2020
6.20,0,0,0,0,0,0,26,0,3,3,331,78413,4634,83378,13,756965,2020
6.21,0,0,0,0,0,0,18,0,2,89,349,78413,4634,83396,15,758023,2020
6.22,0,0,0,0,0,0,22,0,2,12,359,78425,4634,83418,15,758718,2020
6.23,0,0,0,0,0,0,12,0,4,3,368,78428,4634,83430,18,759279,2020
6.24,0,0,0,0,0,0,19,0,0,5,382,78433,4634,83449,13,760157,2020
6.25,0,0,0,0,0,0,13,0,3,6,389,78439,4634,83462,10,760818,2020
6.26,0,0,0,0,0,0,21,0,1,5,405,78444,4634,83483,8,761444,2020
6.27,0,0,0,0,0,0,17,0,1,7,415,78451,4634,83500,8,761721,2020
6.28,0,0,0,0,0,0,12,0,4,9,418,78460,4634,83512,10,762119,2020
6.29,1,0,0,0,0,0,19,0,1,9,428,78469,4634,83531,7,762376,2020
6.30,0,0,0,0,0,0,3,0,2,10,421,78479,4634,83534,8,762744,2020
7.1,0,0,0,0,0,0,3,0,0,8,416,78487,4634,83537,5,762940,2020
7.2,0,0,0,0,0,0,5,0,1,12,409,78499,4634,83542,6,763077,2020
7.3,0,0,0,0,0,0,3,0,2,10,402,78509,4634,83545,7,763277,2020
7.4,0,0,0,0,0,0,8,0,1,7,403,78516,4634,83553,7,763557,2020
7.5,0,0,0,0,0,0,4,0,0,2,405,78518,4634,83557,7,763801,2020
7.6,0,0,0,0,0,0,8,0,2,10,403,78528,4634,83565,7,764486,2020
7.7,0,0,0,0,0,0,7,0,0,20,390,78548,4634,83572,6,765012,2020
7.8,0,0,0,0,0,0,9,0,0,42,357,78590,4634,83581,5,765344,2020
7.9,0,0,0,0,0,0,4,0,3,19,342,78609,4634,83585,8,765615,2020
7.10,0,0,0,0,0,0,2,0,0,14,330,78623,4634,83587,8,765934,2020
7.11,0,0,0,0,0,0,7,0,0,11,326,78634,4634,83594,7,766329,2020
7.12,0,0,0,0,0,0,8,0,0,14,320,78648,4634,83602,7,766622,2020
7.13,0,0,0,0,0,0,3,0,0,26,297,78674,4634,83605,5,766903,2020
7.14,0,0,0,0,0,0,6,0,0,19,284,78693,4634,83611,3,767432,2020
7.15,0,0,0,0,0,0,1,0,0,26,259,78719,4634,83612,3,767532,2020
7.16,0,0,0,0,0,0,10,0,1,18,251,78737,4634,83622,3,767916,2020
7.17,0,0,0,0,0,0,22,0,1,21,252,78758,4634,83644,4,768470,2020
7.18,0,0,0,0,0,0,16,0,1,17,251,78775,4634,83660,4,771589,2020
7.19,0,0,0,0,0,0,22,0,1,24,249,78799,4634,83682,4,772333,2020
7.20,0,0,0,0,0,0,11,0,0,18,242,78817,4634,83693,1,772488,2020
7.21,0,0,0,0,0,0,14,0,0,23,233,78840,4634,83707,1,772804,2020
7.22,0,0,0,0,0,0,22,0,3,15,240,78855,4634,83729,4,773412,2020
7.23,0,0,0,0,0,0,21,0,1,18,243,78873,4634,83750,2,773802,2020
7.24,0,0,0,0,0,0,34,0,2,16,261,78889,4634,83784,2,778052,2020
7.25,1,0,0,0,0,0,46,0,2,19,288,78908,4634,83830,3,779000,2020
7.26,0,0,0,0,0,0,61,0,0,10,339,78918,4634,83891,3,781406,2020
7.27,0,0,0,0,0,0,68,0,0,16,391,78934,4634,83959,1,782284,2020
7.28,0,0,0,0,0,0,101,0,0,10,482,78944,4634,84060,1,783053,2020
7.29,0,0,0,0,0,0,105,0,1,13,574,78957,4634,84165,2,786957,2020
7.30,0,0,0,0,0,0,127,0,1,17,684,78974,4634,84292,2,787335,2020
7.31,0,0,0,0,0,0,45,0,0,15,714,78989,4634,84337,2,789742,2020
8.1,0,0,0,0,0,0,49,0,0,14,748,79003,4634,84385,2,791054,2020
8.2,0,0,0,0,0,0,43,0,3,10,781,79013,4634,84428,4,791776,2020
8.3,0,0,0,0,0,0,36,0,1,17,800,79030,4634,84464,5,792481,2020
8.4,0,0,0,0,0,0,27,0,0,17,810,79047,4634,84491,3,794165,2020
8.5,0,0,0,0,0,0,37,0,0,10,837,79057,4634,84528,2,795607,2020
8.6,0,0,0,0,0,0,37,0,2,31,843,79088,4634,84565,3,798436,2020
8.7,0,0,0,0,0,0,31,0,5,35,839,79123,4634,84596,7,799701,2020
8.8,0,0,0,0,0,0,23,0,0,45,817,79168,4634,84619,6,800268,2020
8.9,0,0,0,0,0,0,49,0,1,64,802,79232,4634,84668,7,800809,2020
8.10,1,0,0,0,0,0,44,0,2,52,794,79284,4634,84712,3,802273,2020
8.11,0,0,0,0,0,0,25,0,1,58,761,79342,4634,84737,3,802908,2020
8.12,0,0,0,0,0,0,19,0,1,56,724,79398,4634,84756,4,803651,2020
8.13,0,0,0,0,0,0,30,0,2,64,690,79462,4634,84786,5,804180,2020
8.14,0,0,0,0,1,0,22,0,1,57,655,79519,4634,84808,3,805075,2020
8.15,0,0,0,0,0,0,19,0,1,56,618,79575,4634,84827,3,805857,2020
8.16,0,0,0,0,0,0,22,0,2,28,612,79603,4634,84849,4,806649,2020
8.17,0,0,0,0,0,0,22,0,0,39,595,79642,4634,84871,3,807383,2020
8.18,0,0,0,0,0,0,17,0,0,43,569,79685,4634,84888,2,808005,2020
8.19,0,0,0,0,0,0,7,0,0,60,516,79745,4634,84895,2,808715,2020
8.20,0,0,0,0,0,0,22,0,0,47,491,79792,4634,84917,0,809209,2020
8.21,0,0,0,0,0,0,22,0,1,59,454,79851,4634,84939,1,810056,2020
8.22,0,0,0,0,0,0,12,0,2,44,422,79895,4634,84951,3,810959,2020
8.23,0,0,0,0,0,0,16,0,1,30,408,79925,4634,84967,2,811824,2020
8.24,0,0,0,0,0,0,14,0,0,36,386,79961,4634,84981,2,812268,2020
8.25,0,0,0,0,0,0,15,0,0,54,347,80015,4634,84996,0,813062,2020
8.26,0,0,0,0,0,0,8,0,1,31,324,80046,4634,85004,1,813571,2020
8.27,0,0,0,0,0,0,9,0,2,45,288,80091,4634,85013,3,814039,2020
8.28,0,0,0,0,0,0,9,0,0,35,262,80126,4634,85022,0,814433,2020
8.29,0,0,0,0,0,0,9,0,0,27,244,80153,4634,85031,0,814635,2020
8.30,0,0,0,0,0,0,17,0,0,24,237,80177,4634,85048,0,814852,2020
8.31,0,0,0,0,0,0,10,0,0,31,216,80208,4634,85058,0,815740,2020
9.1,0,0,0,0,0,0,8,0,0,26,198,80234,4634,85066,0,816307,2020
9.2,0,0,0,0,0,0,11,0,0,17,192,80251,4634,85077,0,816868,2020
9.3,0,0,0,0,0,0,25,0,0,12,205,80263,4634,85102,0,817696,2020
9.4,0,0,0,0,0,0,10,0,0,21,194,80284,4634,85112,0,818203,2020
9.5,0,0,0,0,0,0,10,0,2,18,186,80302,4634,85122,2,818580,2020
9.6,0,0,0,0,0,0,12,0,0,18,180,80320,4634,85134,1,819075,2020
9.7,0,0,0,0,0,0,10,0,0,15,175,80335,4634,85144,1,820007,2020
9.8,0,0,0,0,0,0,2,0,5,12,165,80347,4634,85146,6,820397,2020
9.9,0,0,0,0,0,0,7,0,0,11,161,80358,4634,85153,1,820761,2020
9.10,0,0,0,0,0,0,15,0,0,19,157,80377,4634,85168,1,821220,2020
9.11,0,0,0,0,0,0,6,0,1,9,154,80386,4634,85174,1,821662,2020
9.12,0,0,0,0,0,0,10,0,0,13,151,80399,4634,85184,0,822554,2020
9.13,0,0,0,0,0,0,10,0,3,16,145,80415,4634,85194,3,823002,2020
9.14,0,0,0,0,0,0,8,0,0,11,142,80426,4634,85202,2,823459,2020
9.15,0,0,0,0,0,0,12,0,0,11,143,80437,4634,85214,0,824092,2020
9.16,0,0,0,0,0,0,9,0,1,11,141,80448,4634,85223,1,824740,2020
9.17,0,0,0,0,0,0,32,0,1,8,165,80456,4634,85255,2,825201,2020
9.18,0,0,0,0,0,0,14,0,1,8,171,80464,4634,85269,1,826068,2020
9.19,0,0,0,0,0,0,10,0,1,13,168,80477,4634,85279,2,826677,2020
9.20,0,0,0,0,0,0,12,0,0,7,173,80484,4634,85291,1,826875,2020
9.21,0,0,0,0,0,0,6,0,0,13,166,80497,4634,85297,0,827716,2020
9.22,0,0,0,0,0,0,10,0,0,8,168,80505,4634,85307,0,828204,2020
9.23,0,0,0,0,0,0,7,0,0,8,167,80513,4634,85314,0,828788,2020
9.24,0,0,0,0,0,0,8,0,1,9,166,80522,4634,85322,1,829302,2020
9.25,0,0,0,0,0,0,15,0,1,14,167,80536,4634,85337,2,830088,2020
9.26,0,0,0,0,0,0,14,0,0,5,176,80541,4634,85351,2,830723,2020
9.27,0,0,0,0,0,0,21,0,0,12,185,80553,4634,85372,0,831369,2020
9.28,0,0,0,0,0,0,12,0,1,13,184,80566,4634,85384,1,832332,2020
9.29,0,0,0,0,0,0,19,0,2,12,191,80578,4634,85403,2,832884,2020
9.30,0,0,0,0,0,0,11,0,3,16,186,80594,4634,85414,3,833311,2020
10.1,0,0,0,0,0,0,10,0,0,7,189,80601,4634,85424,3,834101,2020
10.2,0,0,0,0,0,0,10,0,1,10,189,80611,4634,85434,4,834705,2020
10.3,0,0,0,0,0,0,16,0,3,10,195,80621,4634,85450,7,835190,2020
10.4,0,0,0,0,0,0,20,0,0,7,208,80628,4634,85470,6,836287,2020
10.5,0,0,0,0,0,0,12,0,0,7,213,80635,4634,85482,4,837392,2020
10.6,0,0,0,0,0,0,7,0,0,15,205,80650,4634,85489,4,837935,2020
10.7,0,0,0,0,0,0,11,0,1,16,200,80666,4634,85500,5,838333,2020
10.8,0,0,0,0,0,0,21,0,0,15,206,80681,4634,85521,5,838668,2020
10.9,0,0,0,0,0,0,15,0,0,15,206,80696,4634,85536,4,839771,2020
10.10,0,0,0,0,0,0,21,0,5,9,218,80705,4634,85557,9,840380,2020
10.11,0,0,0,0,0,0,21,0,1,9,230,80714,4634,85578,9,841178,2020
10.12,0,0,0,0,0,0,13,0,0,15,228,80729,4634,85591,7,841890,2020
10.13,0,0,0,0,0,0,20,0,2,7,241,80736,4634,85611,5,842832,2020
10.14,0,0,0,0,0,0,11,0,2,12,240,80748,4634,85622,7,843357,2020
10.15,0,0,0,0,0,0,24,0,1,11,253,80759,4634,85646,5,843820,2020
10.16,0,0,0,0,0,0,13,0,1,7,259,80766,4634,85659,5,844662,2020
10.17,0,0,0,0,0,0,13,0,1,20,252,80786,4634,85672,4,845231,2020
10.18,0,0,0,0,0,0,13,0,0,16,249,80802,4634,85685,3,845945,2020
10.19,0,0,0,0,0,0,19,0,3,10,258,80812,4634,85704,6,846829,2020
10.20,0,0,0,0,0,0,11,0,0,22,247,80834,4634,85715,5,847677,2020
10.21,0,0,0,0,0,0,14,0,2,16,245,80850,4634,85729,5,848217,2020
10.22,0,0,0,0,0,0,18,0,2,15,248,80865,4634,85747,7,848666,2020
10.23,0,0,0,0,0,0,28,0,0,11,265,80876,4634,85775,5,849503,2020
10.24,0,0,0,0,0,0,15,0,1,15,265,80891,4634,85790,5,850196,2020
10.25,0,0,0,0,0,0,20,0,1,20,265,80911,4634,85810,6,851586,2020
10.26,0,0,0,0,0,0,16,0,0,17,264,80928,4634,85826,2,852998,2020
10.27,0,0,0,0,0,0,42,0,0,8,298,80936,4634,85868,0,853920,2020
10.28,0,0,0,0,0,0,47,0,0,7,338,80943,4634,85915,0,855855,2020
10.29,0,0,0,0,0,0,25,0,6,24,339,80967,4634,85940,6,858677,2020
10.30,0,0,0,0,0,0,33,0,2,17,355,80984,4634,85973,5,859748,2020
10.31,0,0,0,0,0,0,24,0,0,20,359,81004,4634,85997,0,861405,2020
11.1,0,0,0,0,0,0,24,0,1,20,363,81024,4634,86021,1,862334,2020
11.2,0,0,0,0,0,0,49,0,2,21,391,81045,4634,86070,2,863944,2020
11.3,0,0,0,0,0,0,17,0,1,16,392,81061,4634,86087,2,865425,2020
11.4,2,0,0,0,0,0,28,0,3,20,400,81081,4634,86115,4,865747,2020
11.5,0,0,0,0,0,0,36,0,23,17,419,81098,4634,86151,26,866919,2020
11.6,0,0,0,0,0,0,33,0,0,33,419,81131,4634,86184,23,868043,2020
11.7,0,0,0,0,0,0,28,0,4,37,410,81168,4634,86212,6,869056,2020
11.8,0,0,0,0,0,0,33,0,1,19,424,81187,4634,86245,5,869505,2020
11.9,0,0,0,0,0,0,22,0,0,20,426,81207,4634,86267,2,870889,2020
11.10,0,0,0,0,0,0,17,0,0,21,422,81228,4634,86284,1,871455,2020
11.11,0,0,0,0,0,0,15,0,1,24,413,81252,4634,86299,2,871822,2020
11.12,0,0,0,0,0,0,8,0,0,27,394,81279,4634,86307,2,872244,2020
11.13,0,0,0,0,0,0,18,0,0,24,388,81303,4634,86325,1,872812,2020
11.14,0,0,0,0,0,0,13,0,1,16,385,81319,4634,86338,2,873191,2020
11.15,0,0,0,0,0,0,8,0,1,19,374,81338,4634,86346,3,873756,2020
11.16,0,0,0,0,0,0,15,0,0,36,353,81374,4634,86361,2,874106,2020
11.17,0,0,0,0,0,0,8,0,0,37,324,81411,4634,86369,0,874466,2020
11.18,0,0,0,0,0,0,12,0,0,22,314,81433,4634,86381,0,874707,2020
11.19,0,0,0,0,0,0,17,0,1,20,311,81453,4634,86398,1,875061,2020
11.20,2,0,0,0,0,0,16,0,0,19,308,81472,4634,86414,0,875547,2020
11.21,1,0,0,0,0,0,17,0,0,9,316,81481,4634,86431,0,876138,2020
11.22,0,0,0,0,0,0,11,0,0,12,315,81493,4634,86442,0,876725,2020
11.23,1,0,0,0,0,0,22,0,1,15,322,81508,4634,86464,1,877545,2020
11.24,0,0,0,0,0,0,5,0,1,22,305,81530,4634,86469,2,877795,2020
11.25,0,0,0,0,0,0,21,0,3,20,306,81550,4634,86490,5,877922,2020
11.26,0,0,0,0,0,0,5,0,0,8,303,81558,4634,86495,4,878275,2020
11.27,0,0,0,0,0,0,6,0,0,24,285,81582,4634,86501,4,878626,2020
11.28,0,0,0,0,0,0,11,0,4,16,280,81598,4634,86512,7,879310,2020
11.29,0,0,0,0,0,0,18,0,0,21,277,81619,4634,86530,7,879901,2020
11.30,0,0,0,0,0,0,12,0,0,12,277,81631,4634,86542,6,880179,2020
12.1,0,0,0,0,0,0,9,0,1,18,268,81649,4634,86551,7,881135,2020
12.2,0,0,0,0,0,0,16,0,2,18,266,81667,4634,86567,8,881740,2020
12.3,0,0,0,0,0,0,17,0,1,12,271,81679,4634,86584,8,882239,2020
12.4,0,0,0,0,0,0,17,0,0,15,273,81694,4634,86601,8,882710,2020
12.5,0,0,0,0,0,0,18,0,2,12,279,81706,4634,86619,9,883072,2020
12.6,0,0,0,0,0,0,15,0,2,13,281,81719,4634,86634,5,883662,2020
12.7,0,0,0,0,0,0,12,0,1,13,280,81732,4634,86646,3,884319,2020
12.8,0,0,0,0,0,0,15,0,2,11,284,81743,4634,86661,3,884789,2020
12.9,0,0,0,0,0,0,12,0,2,11,285,81754,4634,86673,3,885409,2020
12.10,0,0,0,0,0,0,15,0,0,8,292,81762,4634,86688,3,885676,2020
12.11,0,0,0,0,0,0,13,0,0,12,293,81774,4634,86701,3,886495,2020
12.12,0,0,0,0,0,0,24,0,1,11,306,81785,4634,86725,2,887031,2020
12.13,0,0,0,0,0,0,16,0,0,9,313,81794,4634,86741,2,887650,2020
12.14,0,0,0,0,0,0,17,0,0,18,312,81812,4634,86758,2,888359,2020
12.15,0,0,0,0,0,0,12,0,1,9,315,81821,4634,86770,3,889134,2020
12.16,0,0,0,0,0,0,7,0,1,21,301,81842,4634,86777,4,889386,2020
12.17,0,0,0,0,0,0,12,0,0,9,304,81851,4634,86789,4,890102,2020
12.18,0,0,0,0,0,0,17,0,1,14,307,81865,4634,86806,5,890499,2020
12.19,0,0,0,0,0,0,23,0,0,21,309,81886,4634,86829,4,891010,2020
12.20,0,0,0,0,0,0,23,0,4,14,318,81900,4634,86852,7,891801,2020
12.21,0,0,0,0,0,0,15,0,0,9,324,81909,4634,86867,1,893304,2020
12.22,0,0,0,0,0,0,15,0,0,19,320,81928,4634,86882,0,893870,2020
12.23,0,0,0,0,0,0,17,0,0,22,315,81950,4634,86899,0,894409,2020
12.24,0,0,0,0,0,0,14,0,0,9,320,81959,4634,86913,0,897690,2020
12.25,0,0,0,0,0,0,20,0,0,12,328,81971,4634,86933,0,900482,2020
12.26,0,0,0,0,0,0,22,0,0,16,334,81987,4634,86955,0,900952,2020
12.27,0,0,0,0,0,0,21,0,1,16,339,82003,4634,86976,1,901517,2020
12.28,0,0,0,0,0,0,27,0,0,18,348,82021,4634,87003,0,902187,2020
12.29,0,0,0,0,0,0,24,0,0,16,356,82037,4634,87027,0,903528,2020
12.30,0,0,0,0,0,0,25,0,0,13,368,82050,4634,87052,0,904515,2020
12.31,0,0,0,0,0,0,19,0,1,17,370,82067,4634,87071,1,905493,2020
1.1,0,0,0,0,0,0,22,0,1,9,383,82076,4634,87093,1,906634,2021
1.2,0,0,0,0,0,0,24,0,0,12,395,82088,4634,87117,1,907460,2021
1.3,0,0,0,0,0,0,33,0,0,17,411,82105,4634,87150,1,909425,2021
1.4,0,0,0,0,0,0,33,0,0,12,432,82117,4634,87183,1,910833,2021
1.5,0,0,0,0,0,0,32,0,2,21,443,82138,4634,87215,3,912596,2021
1.6,0,0,0,0,0,0,63,0,0,21,485,82159,4634,87278,0,915142,2021
1.7,0,0,0,0,0,0,53,0,0,17,521,82176,4634,87331,0,920733,2021
1.8,0,0,0,0,0,0,33,0,1,19,535,82195,4634,87364,1,922790,2021
1.9,0,0,0,0,0,0,69,0,0,16,588,82211,4634,87433,1,924062,2021
1.10,0,0,0,0,0,0,103,0,0,18,673,82229,4634,87536,0,925042,2021
1.11,0,0,0,0,0,0,55,0,0,31,697,82260,4634,87591,0,926793,2021
1.12,0,0,0,0,0,0,115,0,1,28,784,82288,4634,87706,1,929694,2021
1.13,0,0,0,0,0,0,138,1,0,36,885,82324,4635,87844,1,931438,2021
1.14,0,0,0,0,0,0,144,0,1,28,1001,82352,4635,87988,1,933875,2021
1.15,0,0,0,0,0,0,130,0,0,18,1113,82370,4635,88118,1,936427,2021
1.16,0,0,0,0,0,0,109,0,1,17,1205,82387,4635,88227,2,938464,2021
1.17,0,0,0,0,0,0,109,0,2,13,1301,82400,4635,88336,3,940068,2021
1.18,0,0,0,0,0,0,118,0,0,32,1387,82432,4635,88454,2,942449,2021
1.19,0,0,0,0,0,0,103,0,0,17,1473,82449,4635,88557,0,944196,2021
1.20,0,0,0,0,0,0,144,0,5,19,1598,82468,4635,88701,5,947364,2021
1.21,6,0,0,0,0,0,103,0,0,27,1674,82495,4635,88804,5,949349,2021
1.22,3,0,0,0,0,0,107,0,2,31,1750,82526,4635,88911,3,951804,2021
1.23,3,0,0,0,0,0,80,0,1,30,1800,82556,4635,88991,2,954707,2021
1.24,1,0,0,0,0,0,124,0,1,75,1850,82630,4635,89115,2,956533,2021
1.25,2,0,0,0,0,0,82,1,3,46,1885,82676,4636,89197,4,957984,2021
1.26,1,0,0,0,0,0,75,0,1,98,1862,82774,4636,89272,2,960962,2021
1.27,0,0,0,0,0,0,54,0,0,96,1820,82870,4636,89326,1,962317,2021
1.28,0,0,0,0,0,0,52,0,2,70,1802,82940,4636,89378,2,963237,2021
1.29,2,0,0,0,0,0,52,0,1,143,1711,83083,4636,89430,2,964954,2021
1.30,0,0,0,0,0,0,92,0,0,135,1668,83218,4636,89522,2,966100,2021
1.31,0,0,0,0,0,0,42,0,0,96,1614,83314,4636,89564,1,966680,2021
2.1,0,0,0,0,0,0,30,0,0,62,1582,83376,4636,89594,1,967415,2021
2.2,0,0,0,0,0,0,25,0,1,91,1516,83467,4636,89619,2,968131,2021
2.3,3,0,0,0,0,0,30,0,1,135,1411,83602,4636,89649,1,968773,2021
2.4,1,0,0,0,0,0,20,0,3,127,1304,83729,4636,89669,4,969384,2021
2.5,0,0,0,0,0,0,12,0,1,81,1235,83810,4636,89681,2,970103,2021
2.6,0,0,0,0,0,0,11,0,2,70,1176,83880,4636,89692,3,970667,2021
2.7,0,0,0,0,0,0,14,0,0,72,1118,83952,4636,89706,3,971472,2021
2.8,0,0,0,0,0,0,14,0,1,75,1057,84027,4636,89720,2,972002,2021
2.9,0,0,0,0,0,0,14,0,0,102,969,84129,4636,89734,2,972332,2021
2.10,0,0,0,0,0,0,2,0,1,92,879,84221,4636,89736,2,972737,2021
2.11,0,0,0,0,0,0,12,0,0,71,820,84292,4636,89748,2,973104,2021
2.12,0,0,0,0,0,0,8,0,0,65,763,84357,4636,89756,1,973429,2021
2.13,0,0,0,0,0,0,7,0,0,81,689,84438,4636,89763,1,974156,2021
2.14,0,0,0,0,0,0,9,0,0,61,637,84499,4636,89772,1,974265,2021
2.15,0,0,0,0,0,0,16,0,0,48,605,84547,4636,89788,1,974607,2021
2.16,0,0,0,0,0,0,7,0,5,55,557,84602,4636,89795,6,974753,2021
2.17,0,0,0,0,0,0,11,0,1,48,520,84650,4636,89806,6,974949,2021
2.18,0,0,0,0,0,0,10,0,0,46,484,84696,4636,89816,4,975316,2021
2.19,0,0,0,0,0,0,8,0,0,38,454,84734,4636,89824,2,975756,2021
2.20,0,0,0,0,0,0,7,0,2,38,423,84772,4636,89831,3,976157,2021
2.21,0,0,0,0,0,0,11,0,1,33,401,84805,4636,89842,3,976500,2021
2.22,0,0,0,0,0,0,10,0,0,37,374,84842,4636,89852,1,976922,2021
2.23,0,0,0,0,0,0,12,0,3,16,370,84858,4636,89864,3,977301,2021
2.24,0,0,0,0,0,0,7,0,1,96,281,84954,4636,89871,4,977508,2021
2.25,0,0,0,0,0,0,6,0,0,43,244,84997,4636,89877,1,977734,2021
2.26,0,0,0,0,0,0,10,0,1,24,230,85021,4636,89887,2,977995,2021
2.27,0,0,0,0,0,0,6,0,1,18,218,85039,4636,89893,3,978249,2021
2.28,0,0,0,0,0,0,19,0,0,27,210,85066,4636,89912,1,978836,2021
3.1,0,0,0,0,0,0,11,0,0,21,200,85087,4636,89923,1,979150,2021
3.2,0,0,0,0,0,0,10,0,2,24,186,85111,4636,89933,2,979653,2021
3.3,0,0,0,0,0,0,10,0,1,19,177,85130,4636,89943,2,979880,2021
3.4,0,0,0,0,0,0,9,0,2,8,178,85138,4636,89952,2,980117,2021
3.5,0,0,0,0,0,0,10,0,0,15,173,85153,4636,89962,0,980565,2021
3.6,0,0,0,0,0,0,13,0,1,13,173,85166,4636,89975,1,980994,2021
3.7,0,0,0,0,0,0,19,0,0,9,183,85175,4636,89994,1,981326,2021
3.8,0,0,0,0,0,0,8,0,0,11,180,85186,4636,90002,0,981758,2021
3.9,0,0,0,0,0,0,5,0,3,8,177,85194,4636,90007,3,982120,2021
3.10,0,0,0,0,0,0,11,0,0,7,181,85201,4636,90018,2,982409,2021
3.11,0,0,0,0,0,0,9,0,1,8,182,85209,4636,90027,1,982687,2021
3.12,0,0,0,0,0,0,7,0,0,5,184,85214,4636,90034,0,982988,2021
3.13,0,0,0,0,0,0,10,0,1,11,183,85225,4636,90044,1,983291,2021
3.14,0,0,0,0,0,0,5,0,0,13,175,85238,4636,90049,1,983443,2021
3.15,0,0,0,0,0,0,13,0,0,6,182,85244,4636,90062,0,983600,2021
3.16,0,0,0,0,0,0,4,0,4,10,176,85254,4636,90066,4,984232,2021
3.17,0,0,0,0,0,0,6,0,2,13,169,85267,4636,90072,6,984416,2021
3.18,0,0,0,0,0,0,11,0,1,16,164,85283,4636,90083,4,984534,2021
3.19,0,0,0,0,0,0,4,0,1,6,162,85289,4636,90087,4,984870,2021
3.20,0,0,0,0,0,0,12,0,2,9,165,85298,4636,90099,4,985138,2021
3.21,0,0,0,0,0,0,7,0,0,11,161,85309,4636,90106,4,985465,2021
3.22,0,0,0,0,0,0,9,0,0,12,158,85321,4636,90115,2,985520,2021
3.23,0,0,0,0,0,0,10,0,4,10,158,85331,4636,90125,6,985973,2021
3.24,0,0,0,0,0,0,11,0,0,4,165,85335,4636,90136,4,986437,2021
3.25,0,0,0,0,0,0,11,0,1,13,163,85348,4636,90147,4,986872,2021
3.26,0,0,0,0,0,0,12,0,0,14,161,85362,4636,90159,2,987472,2021
3.27,0,0,0,0,0,0,8,0,1,2,167,85364,4636,90167,2,988020,2021
3.28,0,0,0,0,0,0,15,0,0,10,172,85374,4636,90182,2,988501,2021
3.29,0,0,0,0,0,0,8,0,0,7,173,85381,4636,90190,2,989020,2021
3.30,0,0,0,0,0,0,11,0,1,4,180,85385,4636,90201,3,989470,2021
3.31,0,0,0,0,0,0,16,0,0,9,187,85394,4636,90217,3,989820,2021
4.1,0,0,0,0,0,0,9,0,2,8,188,85402,4636,90226,5,990865,2021
4.2,0,0,0,0,0,0,26,0,0,11,203,85413,4636,90252,3,991818,2021
4.3,0,0,0,0,0,0,21,0,2,9,215,85422,4636,90273,3,992439,2021
4.4,0,0,0,0,0,0,32,0,0,9,238,85431,4636,90305,2,993361,2021
4.5,0,0,0,0,0,0,24,0,0,18,244,85449,4636,90329,1,993919,2021
4.6,0,0,0,0,0,0,12,0,0,8,248,85457,4636,90341,1,994598,2021
4.7,0,0,0,0,0,0,24,0,0,9,263,85466,4636,90365,1,994852,2021
4.8,0,0,0,0,0,0,21,0,1,5,279,85471,4636,90386,2,995259,2021
4.9,0,0,0,0,0,0,14,0,0,10,283,85481,4636,90400,2,995588,2021
4.10,0,0,0,0,0,0,10,0,0,7,286,85488,4636,90410,1,996340,2021
4.11,0,0,0,0,0,0,16,0,1,7,295,85495,4636,90426,1,996857,2021
4.12,0,0,0,0,0,0,9,0,0,11,293,85506,4636,90435,0,997604,2021
4.13,0,0,0,0,0,0,12,0,2,7,298,85513,4636,90447,2,1000434,2021
4.14,0,0,0,0,0,0,10,0,1,11,297,85524,4636,90457,3,1000991,2021
4.15,0,0,0,0,0,0,11,0,0,9,299,85533,4636,90468,2,1001478,2021
4.16,0,0,0,0,0,0,15,0,0,5,309,85538,4636,90483,2,1002045,2021
4.17,0,0,0,0,0,0,16,0,1,11,314,85549,4636,90499,3,1002318,2021
4.18,0,0,0,0,0,0,11,0,1,10,315,85559,4636,90510,4,1002777,2021
4.19,0,0,0,0,0,0,10,0,0,14,311,85573,4636,90520,4,1003205,2021
4.20,0,0,0,0,0,0,21,0,0,27,305,85600,4636,90541,1,1004270,2021
4.21,0,0,0,0,0,0,6,0,2,8,303,85608,4636,90547,3,1004517,2021
4.22,0,0,0,0,0,0,19,0,0,16,306,85624,4636,90566,2,1004821,2021
4.23,0,0,0,0,0,0,9,0,3,10,305,85634,4636,90575,5,1005152,2021
4.24,0,0,0,0,0,0,13,0,2,10,308,85644,4636,90588,6,1005271,2021
4.25,0,0,0,0,0,0,11,0,0,8,311,85652,4636,90599,6,1005931,2021
4.26,0,0,0,0,0,0,11,0,0,6,316,85658,4636,90610,3,1006364,2021
4.27,0,0,0,0,0,0,12,0,4,11,317,85669,4636,90622,7,1006693,2021
4.28,0,0,0,0,0,0,20,0,1,13,324,85682,4636,90642,7,1007223,2021
4.29,0,0,0,0,0,0,13,0,3,9,328,85691,4636,90655,10,1007605,2021
4.30,0,0,0,0,0,0,16,0,3,19,325,85710,4636,90671,11,1008010,2021
5.1,0,0,0,0,0,0,15,0,1,15,325,85725,4636,90686,11,1008496,2021
5.2,0,0,0,0,0,0,11,0,0,13,323,85738,4636,90697,11,1008891,2021
5.3,0,0,0,0,0,0,17,0,0,15,325,85753,4636,90714,6,1009335,2021
5.4,0,0,0,0,0,0,7,0,6,13,319,85766,4636,90721,11,1009577,2021
5.5,0,0,0,0,0,0,5,0,1,10,314,85776,4636,90726,12,1009708,2021
5.6,0,0,0,0,0,0,13,0,0,19,308,85795,4636,90739,1,1010192,2021
5.7,0,0,0,0,0,0,7,0,4,15,300,85810,4636,90746,4,1010671,2021
5.8,0,0,0,0,0,0,12,0,0,12,300,85822,4636,90758,1,1010948,2021
5.9,0,0,0,0,0,0,11,0,0,13,298,85835,4636,90769,1,1012040,2021
5.10,0,0,0,0,0,0,14,0,1,10,302,85845,4636,90783,2,1012557,2021
5.11,0,0,0,0,0,0,16,0,0,16,302,85861,4636,90799,1,1012946,2021
5.12,0,0,0,0,0,0,9,0,0,20,291,85881,4636,90808,0,1013232,2021
5.13,0,0,0,0,0,0,7,0,1,13,285,85894,4636,90815,1,1013881,2021
5.14,0,0,0,0,0,0,14,0,0,20,279,85914,4636,90829,1,1014401,2021
5.15,0,0,0,0,0,0,18,0,1,6,291,85920,4636,90847,2,1014784,2021
5.16,0,0,0,0,0,0,25,0,1,25,291,85945,4636,90872,1,1016014,2021
5.17,0,0,0,0,0,0,22,0,1,18,295,85963,4636,90894,1,1016705,2021
5.18,0,0,0,0,0,0,14,0,0,13,296,85976,4636,90908,1,1017439,2021
5.19,0,0,0,0,0,0,12,0,0,14,294,85990,4636,90920,1,1017906,2021
5.20,0,0,0,0,0,0,24,0,0,15,303,86005,4636,90944,1,1018367,2021
5.21,0,0,0,0,0,1,10,0,2,12,301,86017,4636,90954,3,1018845,2021
5.22,0,0,0,0,0,1,19,0,0,5,315,86022,4636,90973,2,1019372,2021
5.23,0,0,0,0,0,3,18,0,1,8,325,86030,4636,90991,3,1019971,2021
5.24,0,0,0,0,0,1,15,0,0,21,319,86051,4636,91006,3,1020846,2021
5.25,0,0,0,0,0,3,13,0,0,12,320,86063,4636,91019,2,1021397,2021
5.26,0,0,0,0,0,4,19,0,0,12,327,86075,4636,91038,2,1022360,2021
5.27,0,0,0,0,0,5,7,0,2,18,316,86093,4636,91045,3,1022850,2021
5.28,0,0,0,0,0,8,16,0,0,14,318,86107,4636,91061,2,1023485,2021
5.29,0,0,0,0,0,13,11,0,0,10,319,86117,4636,91072,2,1024113,2021
5.30,0,0,0,0,0,3,27,0,0,18,328,86135,4636,91099,2,1024783,2021
5.31,0,0,0,0,0,2,23,0,1,14,337,86149,4636,91122,2,1025453,2021
6.1,0,0,0,0,0,7,24,0,0,15,346,86164,4636,91146,2,1026143,2021
6.2,0,0,0,0,0,5,24,0,0,6,364,86170,4636,91170,2,1027007,2021
6.3,0,0,0,0,0,1,24,0,0,17,371,86187,4636,91194,2,1027742,2021
6.4,0,0,0,0,0,3,24,0,1,10,385,86197,4636,91218,3,1028538,2021
6.5,0,0,0,0,0,3,30,0,2,23,392,86220,4636,91248,4,1029442,2021
6.6,0,0,0,0,0,2,19,0,0,8,403,86228,4636,91267,2,1030389,2021
6.7,0,0,0,0,0,0,33,0,0,27,409,86255,4636,91300,2,1031331,2021
6.8,0,0,0,0,0,0,16,0,11,12,413,86267,4636,91316,11,1032227,2021
6.9,0,0,0,0,0,0,21,0,0,18,416,86285,4636,91337,11,1034038,2021
6.10,0,0,0,0,0,0,22,0,9,12,426,86297,4636,91359,10,1035600,2021
6.11,0,0,0,0,0,0,35,0,1,15,446,86312,4636,91394,10,1036547,2021
6.12,0,0,0,0,0,0,34,0,1,21,459,86333,4636,91428,2,1037435,2021
6.13,0,0,0,0,0,0,23,0,0,11,471,86344,4636,91451,2,1039286,2021
6.14,0,0,0,0,0,0,20,0,0,8,483,86352,4636,91471,2,1041719,2021
6.15,0,0,0,0,0,0,21,0,3,17,487,86369,4636,91492,3,1042993,2021
6.16,0,0,0,0,0,0,19,0,0,15,491,86384,4636,91511,1,1045269,2021
6.17,0,0,0,0,0,0,23,0,1,13,501,86397,4636,91534,1,1045718,2021
6.18,0,0,0,0,0,0,30,0,1,28,503,86425,4636,91564,1,1046793,2021
6.19,0,0,0,0,0,0,23,0,0,16,510,86441,4636,91587,1,1047938,2021
6.20,0,0,0,0,0,0,17,0,0,8,519,86449,4636,91604,1,1049675,2021
6.21,0,0,0,0,0,0,25,0,0,32,512,86481,4636,91629,1,1050705,2021
6.22,0,0,0,0,0,0,24,0,0,22,514,86503,4636,91653,1,1051636,2021
6.23,0,0,0,0,0,0,16,0,1,38,492,86541,4636,91669,2,1053735,2021
6.24,0,0,0,0,0,0,24,0,7,30,486,86571,4636,91693,9,1054578,2021
6.25,0,0,0,0,0,0,25,0,0,37,474,86608,4636,91718,0,1056427,2021
6.26,0,0,0,0,0,0,14,0,0,26,462,86634,4636,91732,0,1057064,2021
6.27,0,0,0,0,0,0,21,0,1,21,462,86655,4636,91753,1,1057634,2021
6.28,0,0,0,0,0,0,18,0,0,21,459,86676,4636,91771,1,1058670,2021
6.29,0,0,0,0,0,0,9,0,0,13,455,86689,4636,91780,0,1059505,2021
6.30,0,0,0,0,0,0,12,0,0,29,438,86718,4636,91792,0,1060056,2021
7.1,0,0,0,0,0,0,18,0,1,20,436,86738,4636,91810,1,1060523,2021
7.2,0,0,0,0,0,0,23,0,7,28,431,86766,4636,91833,7,1061312,2021
7.3,0,0,0,0,0,0,14,0,3,17,428,86783,4636,91847,3,1061552,2021
7.4,0,0,0,0,0,0,22,0,0,21,429,86804,4636,91869,3,1061862,2021
7.5,0,0,0,0,0,0,23,0,0,34,418,86838,4636,91892,1,1062534,2021
7.6,0,0,0,0,0,0,57,0,4,17,458,86855,4636,91949,5,1063276,2021
7.7,0,0,0,0,0,0,17,0,2,28,447,86883,4636,91966,4,1064151,2021
7.8,0,0,0,0,0,0,23,0,0,19,451,86902,4636,91989,3,1065135,2021
7.9,0,0,0,0,0,0,26,0,2,16,461,86918,4636,92015,2,1065872,2021
7.10,0,0,0,0,0,0,24,0,1,19,466,86937,4636,92039,3,1066268,2021
7.11,0,0,0,0,0,0,27,0,1,15,478,86952,4636,92066,4,1066762,2021
7.12,0,0,0,0,0,0,29,0,0,15,492,86967,4636,92095,3,1067174,2021
7.13,0,0,0,0,0,0,24,0,0,15,501,86982,4636,92119,2,1067675,2021
7.14,0,0,0,0,0,0,28,0,0,23,506,87005,4636,92147,2,1068164,2021
7.15,0,0,0,0,0,0,36,0,0,6,536,87011,4636,92183,0,1068538,2021
7.16,0,0,0,0,0,0,30,0,0,28,538,87039,4636,92213,0,1068971,2021
7.17,0,0,0,0,0,0,33,0,0,22,549,87061,4636,92246,0,1069428,2021
7.18,0,0,0,0,0,0,31,0,0,15,565,87076,4636,92277,0,1070048,2021
7.19,0,0,0,0,0,1,65,0,1,22,608,87098,4636,92342,1,1070817,2021
7.20,0,0,0,0,0,0,22,0,1,28,602,87126,4636,92364,2,1071606,2021
7.21,0,0,0,0,0,0,50,0,1,14,638,87140,4636,92414,1,1072384,2021
7.22,0,0,0,0,0,1,48,0,3,23,663,87163,4636,92462,4,1072912,2021
7.23,0,0,0,0,0,0,35,0,0,17,681,87180,4636,92497,3,1074416,2021
7.24,0,0,0,0,1,0,32,0,0,21,692,87201,4636,92529,2,1074783,2021
7.25,0,0,0,0,0,1,76,0,0,27,741,87228,4636,92605,2,1075952,2021
7.26,0,0,0,0,0,0,71,0,4,17,795,87245,4636,92676,4,1077340,2021
7.27,0,0,0,0,0,0,86,0,0,19,862,87264,4636,92762,4,1078888,2021
7.28,0,0,0,0,0,0,49,0,1,24,887,87288,4636,92811,5,1081486,2021
7.29,0,0,0,0,0,0,64,0,1,19,932,87307,4636,92875,2,1084620,2021
7.30,0,0,0,0,0,0,55,0,1,16,971,87323,4636,92930,2,1087011,2021
7.31,0,0,0,0,0,0,75,0,1,24,1022,87347,4636,93005,2,1093589,2021
8.1,0,0,0,0,0,0,98,0,0,29,1091,87376,4636,93103,1,1098701,2021
8.2,1,0,0,0,0,0,90,0,0,24,1157,87400,4636,93193,0,1102493,2021
8.3,0,0,0,0,0,0,96,0,2,13,1240,87413,4636,93289,2,1107456,2021
8.4,0,0,0,0,0,0,85,0,2,40,1285,87453,4636,93374,2,1111137,2021
8.5,0,0,0,0,0,0,124,0,3,39,1370,87492,4636,93498,3,1115176,2021
8.6,0,0,0,0,0,0,107,0,1,33,1444,87525,4636,93605,1,1119620,2021
8.7,0,0,0,0,0,0,96,0,3,33,1507,87558,4636,93701,4,1123517,2021
8.8,0,0,0,0,0,0,125,0,0,29,1603,87587,4636,93826,1,1127361,2021
8.9,0,0,0,0,0,0,143,0,1,44,1702,87631,4636,93969,2,1131521,2021
8.10,0,0,0,0,0,0,111,0,0,24,1789,87655,4636,94080,1,1135904,2021
8.11,0,0,0,0,0,0,81,0,2,34,1836,87689,4636,94161,3,1138795,2021
8.12,0,0,0,0,0,0,99,0,1,51,1884,87740,4636,94260,3,1141584,2021
8.13,0,0,0,0,0,0,66,0,0,43,1907,87783,4636,94326,2,1144391,2021
8.14,0,0,0,0,0,0,53,0,0,38,1922,87821,4636,94379,1,1146611,2021
8.15,0,0,0,0,0,0,51,0,0,35,1938,87856,4636,94430,1,1150082,2021
8.16,0,0,0,0,0,0,42,0,1,52,1928,87908,4636,94472,1,1151965,2021
8.17,0,0,0,0,0,0,28,0,1,69,1887,87977,4636,94500,1,1153308,2021
8.18,1,0,0,0,0,0,46,0,1,67,1866,88044,4636,94546,2,1154405,2021
8.19,0,0,0,0,0,0,33,0,2,82,1817,88126,4636,94579,4,1155346,2021
8.20,2,0,0,0,0,0,20,0,0,51,1786,88177,4636,94599,2,1155895,2021
8.21,3,0,0,0,0,0,32,0,0,70,1748,88247,4636,94631,0,1157386,2021
8.22,0,0,0,0,0,0,21,0,1,74,1695,88321,4636,94652,1,1158348,2021
8.23,0,0,0,0,0,0,35,0,1,96,1634,88417,4636,94687,2,1159314,2021
8.24,2,0,0,0,0,0,20,0,1,79,1575,88496,4636,94707,1,1159477,2021
8.25,0,0,0,0,0,0,26,0,1,104,1497,88600,4636,94733,2,1159654,2021
8.26,1,0,0,0,0,0,32,0,1,98,1431,88698,4636,94765,2,1160352,2021
8.27,0,0,0,0,0,0,21,0,0,107,1345,88805,4636,94786,0,1160911,2021
8.28,0,0,0,0,0,0,33,0,1,119,1259,88924,4636,94819,1,1161449,2021
8.29,0,0,0,0,0,0,23,0,4,107,1175,89031,4636,94842,4,1162043,2021
8.30,0,0,0,0,0,0,37,0,1,114,1098,89145,4636,94879,1,1162974,2021
8.31,0,0,0,0,0,0,19,0,2,95,1022,89240,4636,94898,3,1163705,2021
9.1,0,0,0,0,0,0,28,0,0,73,977,89313,4636,94926,1,1164509,2021
9.2,0,0,0,0,0,0,28,0,2,70,935,89383,4636,94954,2,1165275,2021
9.3,0,0,0,0,0,0,28,0,2,55,908,89438,4636,94982,2,1165817,2021
9.4,0,0,0,0,0,1,28,0,0,60,876,89498,4636,95010,0,1166128,2021
9.5,0,0,0,0,0,1,18,0,0,54,840,89552,4636,95028,0,1166595,2021
9.6,0,0,0,0,0,0,36,0,0,50,826,89602,4636,95064,0,1167006,2021
9.7,0,0,0,0,0,0,19,0,1,50,795,89652,4636,95083,1,1167468,2021
9.8,0,0,0,0,0,0,28,0,0,37,786,89689,4636,95111,1,1168105,2021
9.9,0,0,0,0,0,0,17,0,1,47,756,89736,4636,95128,2,1168375,2021
9.10,0,0,0,0,0,1,25,0,2,50,731,89786,4636,95153,3,1169405,2021
9.11,0,0,0,0,0,0,46,0,0,37,740,89823,4636,95199,2,1170339,2021
9.12,0,0,0,0,0,0,49,0,0,38,751,89861,4636,95248,3,1171158,2021
9.13,0,0,0,0,0,0,92,0,0,33,810,89894,4636,95340,0,1174044,2021
9.14,0,0,0,0,0,0,73,0,1,46,837,89940,4636,95413,1,1175662,2021
9.15,0,0,0,0,0,0,80,0,0,40,877,89980,4636,95493,0,1177197,2021
9.16,0,0,0,0,0,0,84,0,2,45,916,90025,4636,95577,2,1177935,2021
9.17,0,0,0,0,0,0,46,0,0,49,913,90074,4636,95623,1,1179064,2021
9.18,0,0,0,0,0,0,66,0,0,52,927,90126,4636,95689,1,1179684,2021
9.19,0,0,0,0,0,0,49,0,2,34,942,90160,4636,95738,3,1180253,2021
9.20,0,0,0,0,0,0,72,0,2,34,980,90194,4636,95810,4,1180972,2021
9.21,0,0,0,0,0,0,41,0,2,37,984,90231,4636,95851,4,1182333,2021
9.22,0,0,0,0,0,0,43,0,2,37,990,90268,4636,95894,4,1183674,2021
9.23,0,0,0,0,0,0,54,0,1,35,1009,90303,4636,95948,2,1184228,2021
9.24,0,0,0,0,0,0,38,0,2,27,1020,90330,4636,95986,4,1186155,2021
9.25,0,0,0,0,0,0,29,0,0,36,1013,90366,4636,96015,4,1187461,2021
9.26,0,0,0,0,0,0,35,0,0,36,1012,90402,4636,96050,2,1188820,2021
9.27,0,0,0,0,0,0,31,0,0,61,982,90463,4636,96081,1,1194626,2021
9.28,0,0,0,0,0,0,25,0,0,58,949,90521,4636,96106,0,1196993,2021
9.29,0,0,0,0,0,0,22,0,1,63,908,90584,4636,96128,1,1198043,2021
9.30,0,0,0,0,0,0,34,0,2,50,892,90634,4636,96162,2,1199462,2021
10.1,0,0,0,0,0,0,41,0,0,43,890,90677,4636,96203,0,1200303,2021
10.2,0,0,0,0,0,0,28,0,0,50,868,90727,4636,96231,0,1200786,2021
10.3,0,0,0,0,0,0,27,0,0,38,857,90765,4636,96258,0,1201863,2021
10.4,0,0,0,0,0,0,26,0,1,27,856,90792,4636,96284,1,1202843,2021
10.5,0,0,0,0,0,0,26,0,0,44,838,90836,4636,96310,1,1203454,2021
10.6,0,0,0,0,0,0,25,0,1,53,810,90889,4636,96335,2,1204155,2021
10.7,0,0,0,0,0,0,22,0,0,46,786,90935,4636,96357,2,1204742,2021
10.8,0,0,0,0,0,0,17,0,1,37,766,90972,4636,96374,2,1205442,2021
10.9,0,0,0,0,0,0,24,0,0,59,731,91031,4636,96398,1,1206394,2021
10.10,0,0,0,0,0,0,25,0,0,43,713,91074,4636,96423,1,1206704,2021
10.11,0,0,0,0,0,0,12,0,0,56,669,91130,4636,96435,1,1207323,2021
10.12,0,0,0,0,0,0,22,0,1,46,645,91176,4636,96457,2,1207671,2021
10.13,0,0,0,0,0,0,21,0,0,36,630,91212,4636,96478,2,1208390,2021
10.14,0,0,0,0,0,0,10,0,1,84,556,91296,4636,96488,2,1208771,2021
10.15,0,0,0,0,0,0,14,0,0,49,521,91345,4636,96502,2,1209424,2021
10.16,0,0,0,0,0,0,20,0,0,23,518,91368,4636,96522,1,1211870,2021
10.17,0,0,0,0,0,0,24,0,0,26,516,91394,4636,96546,1,1212607,2021
10.18,0,0,0,0,0,0,25,0,1,27,514,91421,4636,96571,2,1213842,2021
10.19,0,0,0,0,0,0,30,0,0,39,505,91460,4636,96601,2,1216152,2021
10.20,0,0,0,0,0,0,21,0,0,34,492,91494,4636,96622,1,1218545,2021
10.21,0,0,0,0,0,0,43,0,0,17,518,91511,4636,96665,1,1222061,2021
10.22,0,0,0,0,0,0,50,0,1,19,549,91530,4636,96715,2,1224969,2021
10.23,0,0,0,0,0,0,43,0,0,28,564,91558,4636,96758,2,1227655,2021
10.24,0,0,0,0,0,0,39,0,1,30,573,91588,4636,96797,3,1230300,2021
10.25,0,0,0,0,0,0,43,0,1,13,603,91601,4636,96840,4,1233485,2021
10.26,0,0,0,0,0,0,59,0,0,19,643,91620,4636,96899,4,1237350,2021
10.27,0,0,0,0,0,0,39,0,0,23,659,91643,4636,96938,4,1240694,2021
10.28,0,0,0,0,0,0,64,0,1,22,701,91665,4636,97002,3,1244628,2021
10.29,0,0,0,0,0,0,78,0,0,16,763,91681,4636,97080,3,1249288,2021
10.30,0,0,0,0,0,0,71,0,3,20,814,91701,4636,97151,6,1252754,2021
10.31,0,0,0,0,0,0,92,0,1,37,869,91738,4636,97243,5,1255691,2021
11.1,0,0,0,0,0,0,71,0,2,28,912,91766,4636,97314,3,1258560,2021
11.2,0,0,0,0,0,0,109,0,1,21,1000,91787,4636,97423,3,1262122,2021
11.3,0,0,0,0,0,0,104,0,3,24,1080,91811,4636,97527,4,1266727,2021
11.4,0,0,0,0,0,0,78,0,1,29,1129,91840,4636,97605,4,1272333,2021
11.5,0,0,0,0,0,0,55,0,0,43,1141,91883,4636,97660,1,1274940,2021
11.6,0,0,0,0,0,0,74,0,2,46,1169,91929,4636,97734,3,1277806,2021
11.7,0,0,0,0,0,0,89,0,0,56,1202,91985,4636,97823,1,1281004,2021
11.8,0,0,0,0,0,0,62,0,0,42,1222,92027,4636,97885,1,1283647,2021
11.9,0,0,0,0,0,0,54,0,1,54,1222,92081,4636,97939,2,1285582,2021
11.10,0,0,0,0,0,0,62,0,0,38,1246,92119,4636,98001,2,1291844,2021
11.11,0,0,0,0,0,0,98,0,0,64,1280,92183,4636,98099,2,1293053,2021
11.12,0,0,0,0,0,0,75,0,1,46,1309,92229,4636,98174,3,1294716,2021
11.13,0,0,0,0,0,0,89,0,0,48,1350,92277,4636,98263,2,1295958,2021
11.14,0,0,0,0,0,0,52,0,2,55,1347,92332,4636,98315,4,1297645,2021
11.15,0,0,0,0,0,0,22,0,1,74,1295,92406,4636,98337,2,1298631,2021
11.16,0,0,0,0,0,0,31,0,2,69,1257,92475,4636,98368,4,1299515,2021
11.17,0,0,0,0,0,0,35,0,0,59,1233,92534,4636,98403,3,1300285,2021
11.18,0,0,0,0,0,0,24,0,0,51,1206,92585,4636,98427,2,1300757,2021
11.19,0,0,0,0,0,0,23,0,0,71,1158,92656,4636,98450,2,1301242,2021
11.20,0,0,0,0,0,0,17,0,1,77,1098,92733,4636,98467,3,1301951,2021
11.21,0,0,0,0,0,0,38,0,2,85,1051,92818,4636,98505,4,1302902,2021
11.22,0,0,0,0,0,0,19,0,0,64,1006,92882,4636,98524,3,1303584,2021
11.23,0,0,0,0,0,0,22,0,0,70,958,92952,4636,98546,1,1304284,2021
11.24,0,0,0,0,0,0,24,0,1,68,914,93020,4636,98570,2,1310344,2021
11.25,3,0,0,0,0,0,13,0,2,67,860,93087,4636,98583,4,1315485,2021
11.26,0,0,0,0,0,0,25,0,0,76,809,93163,4636,98608,2,1319872,2021
11.27,0,1,0,0,0,0,23,0,2,47,785,93210,4636,98631,3,1323851,2021
11.28,0,0,0,0,0,0,41,0,0,39,787,93249,4636,98672,3,1327083,2021
11.29,0,0,0,0,0,0,39,0,0,36,790,93285,4636,98711,3,1328055,2021
11.30,0,0,0,0,0,0,113,0,0,35,868,93320,4636,98824,2,1329260,2021
12.1,0,0,0,0,0,0,73,0,1,35,906,93355,4636,98897,2,1330782,2021
12.2,2,0,0,0,0,0,96,0,3,30,972,93385,4636,98993,5,1332534,2021
12.3,0,1,0,0,1,0,90,0,1,49,1013,93434,4636,99083,2,1334589,2021
12.4,0,0,0,0,0,0,59,0,0,36,1036,93470,4636,99142,1,1336954,2021
12.5,0,0,0,0,0,0,61,0,1,37,1060,93507,4636,99203,2,1339086,2021
12.6,0,0,0,0,0,0,94,0,2,47,1107,93554,4636,99297,3,1341664,2021
12.7,1,0,0,0,0,0,74,0,1,48,1133,93602,4636,99371,4,1344901,2021
12.8,0,0,0,0,0,0,83,0,0,26,1190,93628,4636,99454,2,1348974,2021
12.9,0,0,0,0,0,0,63,0,0,31,1222,93659,4636,99517,1,1352338,2021
12.10,0,0,0,0,0,0,87,0,0,37,1272,93696,4636,99604,1,1355094,2021
12.11,0,0,0,0,0,0,75,0,1,24,1323,93720,4636,99679,2,1358671,2021
12.12,0,0,0,0,0,0,101,0,0,43,1381,93763,4636,99780,2,1361008,2021
12.13,0,0,0,0,0,0,76,0,0,26,1431,93789,4636,99856,1,1369115,2021
12.14,0,0,0,0,2,2,67,0,0,38,1460,93827,4636,99923,1,1371391,2021
12.15,0,0,0,0,6,1,77,0,0,31,1506,93858,4636,100000,1,1373829,2021
12.16,0,0,0,0,2,0,76,0,3,26,1556,93884,4636,100076,4,1377744,2021
12.17,1,0,0,0,2,0,125,0,3,33,1648,93917,4636,100201,6,1380114,2021
12.18,0,1,0,0,3,0,83,0,2,46,1685,93963,4636,100284,5,1383104,2021
12.19,0,0,0,0,2,0,102,0,1,51,1736,94014,4636,100386,4,1386785,2021
12.20,0,0,0,0,6,0,81,0,0,49,1768,94063,4636,100467,1,1389524,2021
12.21,0,0,0,0,2,0,77,0,2,80,1765,94143,4636,100544,3,1394304,2021
12.22,0,0,0,0,1,0,100,0,0,42,1823,94185,4636,100644,3,1397457,2021
12.23,0,0,0,0,1,0,87,0,6,59,1851,94244,4636,100731,8,1401028,2021
12.24,4,0,0,0,0,0,140,0,6,110,1881,94354,4636,100871,10,1403530,2021
12.25,0,0,0,0,0,0,206,0,0,76,2011,94430,4636,101077,3,1406467,2021
12.26,2,0,0,0,1,0,200,0,4,53,2158,94483,4636,101277,6,1410265,2021
12.27,0,0,0,0,0,0,209,0,0,92,2275,94575,4636,101486,3,1413092,2021
12.28,0,0,0,0,0,0,197,0,2,57,2415,94632,4636,101683,3,1414788,2021
12.29,0,1,0,0,0,0,207,0,2,59,2563,94691,4636,101890,2,1418221,2021
12.30,0,0,0,0,0,0,195,0,1,42,2714,94733,4636,102083,2,1420758,2021
12.31,0,0,0,0,0,1,231,0,1,59,2886,94792,4636,102314,1,1423756,2021
1.1,0,0,0,0,0,0,191,0,1,64,3013,94856,4636,102505,1,1427650,2022
1.2,0,1,0,0,0,0,161,0,0,47,3127,94903,4636,102666,0,1431026,2022
1.3,0,2,0,0,0,0,175,0,3,46,3256,94949,4636,102841,3,1434795,2022
1.4,0,4,0,0,0,0,91,0,0,56,3291,95005,4636,102932,1,1438066,2022
1.5,0,0,0,0,0,0,189,0,2,198,3282,95203,4636,103121,2,1441120,2022
1.6,0,3,0,0,0,0,174,0,6,97,3359,95300,4636,103295,7,1444595,2022
1.7,0,5,2,0,2,0,159,0,1,151,3367,95451,4636,103454,1,1446939,2022
1.8,0,0,1,0,1,0,165,0,2,140,3392,95591,4636,103619,2,1450893,2022
1.9,0,0,1,0,1,0,157,0,3,145,3404,95736,4636,103776,3,1455102,2022
1.10,0,0,0,0,0,0,192,0,0,138,3458,95874,4636,103968,1,1458340,2022
1.11,0,0,7,1,7,1,221,0,1,203,3476,96077,4636,104189,1,1463589,2022
1.12,0,0,1,1,1,1,190,0,9,206,3460,96283,4636,104379,9,1466364,2022
1.13,2,3,0,0,1,0,201,0,9,230,3431,96513,4636,104580,13,1469816,2022
1.14,0,0,2,0,8,2,165,0,6,145,3451,96658,4636,104745,9,1474381,2022
1.15,0,3,0,0,1,1,119,0,9,109,3461,96767,4636,104864,14,1478462,2022
1.16,0,0,2,0,9,0,223,0,4,190,3494,96957,4636,105087,8,1483318,2022
1.17,0,0,0,0,5,0,171,0,3,135,3530,97092,4636,105258,8,1486846,2022
1.18,0,0,1,0,7,1,87,0,5,163,3454,97255,4636,105345,11,1489867,2022
1.19,0,0,0,0,2,2,66,0,3,223,3297,97478,4636,105411,10,1493645,2022
1.20,0,0,0,0,4,0,73,0,1,197,3173,97675,4636,105484,5,1496694,2022
1.21,0,0,0,0,3,0,63,0,0,175,3061,97850,4636,105547,4,1497939,2022
1.22,0,0,0,0,3,1,56,0,3,197,2920,98047,4636,105603,7,1500340,2022
1.23,0,0,0,0,1,0,57,0,1,223,2754,98270,4636,105660,7,1502026,2022
1.24,1,0,0,0,0,0,45,0,0,183,2616,98453,4636,105705,6,1503506,2022
1.25,0,0,0,0,1,0,44,0,0,173,2487,98626,4636,105749,3,1505286,2022
1.26,1,0,0,0,0,0,63,0,0,188,2361,98814,4636,105811,0,1506684,2022
1.27,0,0,0,0,0,0,64,0,3,157,2268,98971,4636,105875,3,1510597,2022
1.28,0,0,0,0,0,0,59,0,0,200,2127,99171,4636,105934,1,1514010,2022
1.29,0,0,0,0,0,0,81,0,1,182,2026,99353,4636,106015,1,1519457,2022
1.30,0,0,0,0,0,0,58,0,3,147,1937,99500,4636,106073,4,1522986,2022
1.31,0,0,1,0,1,0,66,0,0,119,1884,99619,4636,106139,0,1529275,2022
2.1,0,0,2,1,6,4,63,0,0,145,1802,99764,4636,106202,0,1533257,2022
2.2,0,0,4,0,9,1,39,0,0,100,1741,99864,4636,106241,0,1536152,2022
2.3,0,0,4,0,5,1,29,0,4,97,1673,99961,4636,106270,4,1539398,2022
2.4,0,0,2,0,6,0,27,0,0,129,1571,100090,4636,106297,2,1541240,2022
2.5,0,0,0,0,1,0,43,0,1,104,1510,100194,4636,106340,2,1543306,2022
2.6,0,0,3,0,4,0,79,0,1,94,1495,100288,4636,106419,1,1545664,2022
2.7,0,0,0,0,0,0,105,0,0,127,1473,100415,4636,106524,0,1547273,2022
2.8,0,0,0,0,0,0,110,0,0,88,1495,100503,4636,106634,0,1548704,2022
2.9,0,0,0,0,0,0,29,0,1,96,1428,100599,4636,106663,1,1551339,2022
2.10,0,0,0,0,0,0,101,0,0,105,1424,100704,4636,106764,0,1552962,2022
2.11,0,0,0,0,0,0,99,0,1,87,1436,100791,4636,106863,1,1555374,2022
2.12,0,0,1,0,1,0,67,0,0,106,1397,100897,4636,106930,0,1556902,2022
2.13,0,0,1,0,1,1,84,0,2,83,1398,100980,4636,107014,2,1559239,2022
2.14,0,0,2,0,2,0,80,0,2,80,1398,101060,4636,107094,3,1561451,2022
2.15,0,0,3,0,3,1,102,0,0,81,1419,101141,4636,107196,1,1564392,2022
2.16,0,0,6,2,7,2,92,0,3,91,1420,101232,4636,107288,3,1567039,2022
2.17,0,0,3,0,4,1,87,0,6,84,1423,101316,4636,107375,6,1570254,2022
2.18,0,0,3,0,3,0,137,0,4,78,1482,101394,4636,107512,4,1573894,2022
2.19,0,0,8,0,8,0,195,0,0,55,1622,101449,4636,107707,0,1578614,2022
2.20,0,2,6,1,6,1,144,0,3,42,1724,101491,4636,107851,3,1582455,2022
2.21,0,0,3,0,3,0,138,0,4,53,1809,101544,4636,107989,4,1586886,2022
2.22,0,0,7,1,7,2,205,0,2,54,1960,101598,4636,108194,3,1592507,2022
2.23,0,0,8,1,8,1,186,0,0,48,2098,101646,4636,108380,0,1599801,2022
2.24,0,1,8,5,8,5,224,0,7,68,2254,101714,4636,108604,7,1607712,2022
2.25,0,1,9,9,30,9,249,0,0,72,2431,101786,4636,108853,4,1615287,2022
2.26,0,1,26,4,48,5,239,0,7,82,2588,101868,4636,109092,9,1625299,2022
2.27,0,1,30,6,40,25,234,0,5,68,2754,101936,4636,109326,6,1633142,2022
2.28,0,3,23,5,31,25,200,0,9,81,2873,102017,4636,109526,11,1641681,2022
3.1,1,1,25,0,32,13,224,0,4,98,2999,102115,4636,109750,9,1652133,2022
3.2,3,5,23,2,28,6,214,0,5,119,3094,102234,4636,109964,9,1658062,2022
3.3,2,14,22,1,22,6,294,0,4,84,3304,102318,4636,110258,7,1664814,2022
3.4,3,16,21,0,46,18,281,0,5,120,3465,102438,4636,110539,11,1673729,2022
3.5,0,28,17,0,20,33,329,0,2,103,3691,102541,4636,110868,9,1684197,2022
3.6,3,45,19,0,69,104,327,0,4,181,3837,102722,4636,111195,13,1692210,2022
3.7,4,51,13,0,45,73,325,0,5,110,4052,102832,4636,111520,12,1702180,2022
3.8,3,62,6,0,7,20,337,0,15,181,4208,103013,4636,111857,22,1714781,2022
3.9,4,76,15,0,17,5,528,0,10,126,4610,103139,4636,112385,12,1729080,2022
3.10,11,64,9,2,11,167,555,0,3,141,5024,103280,4636,112940,7,1745633,2022
3.11,5,78,27,2,33,191,588,0,5,151,5461,103431,4636,113528,8,1763059,2022
3.12,1,64,60,6,62,194,1938,0,0,169,7230,103600,4636,115466,4,1786279,2022
3.13,41,128,75,11,79,151,1437,0,1,135,8531,103735,4636,116902,5,1813869,2022
3.14,9,130,39,21,48,68,3602,0,2,149,11984,103884,4636,120504,6,1844212,2022
3.15,5,197,55,37,59,54,1952,0,1,156,13780,104040,4636,122456,6,1883384,2022
3.16,8,150,71,20,83,70,1317,0,8,247,14850,104287,4636,123773,14,1919136,2022
3.17,57,203,69,36,74,61,2461,0,6,337,16974,104624,4636,126234,19,1959395,2022
3.18,8,366,46,31,47,48,2228,2,0,614,18586,105238,4638,128462,7,1989863,2022
3.19,17,492,49,17,51,27,1737,0,3,337,19986,105575,4638,130199,10,2022712,2022
3.20,24,734,33,11,38,16,2027,0,6,625,21388,106200,4638,132226,14,2053069,2022
3.21,31,865,23,5,25,5,2338,0,0,588,23138,106788,4638,134564,14,2080392,2022
3.22,4,977,13,5,15,12,2667,0,3,702,25103,107490,4638,137231,12,2105379,2022
3.23,4,979,5,4,8,8,2054,0,1,904,26253,108394,4638,139285,13,2126193,2022
3.24,27,1582,2,1,4,7,1366,0,5,725,26892,109119,4638,140651,16,2152648,2022
3.25,38,2231,2,5,4,7,1335,0,1,917,50,110036,4638,141986,13,2177326,2022
3.26,47,2631,0,3,2,8,1254,0,0,999,27567,111035,4638,143240,13,2212014,2022
3.27,50,3450,1,6,4,18,1275,0,6,1097,27745,112132,4638,144515,19,2236344,2022
3.28,96,4381,3,6,8,10,1293,0,0,1179,27859,113311,4638,145808,15,2258351,2022
3.29,326,5656,1,7,2,14,1629,0,2,1325,28163,114636,4638,147437,17,2282407,2022
3.30,355,5298,6,3,11,8,1839,0,2,1403,28599,116039,4638,149276,18,2306745,2022
3.31,358,4144,0,2,4,14,1827,0,2,1120,29306,117159,4638,151103,20,2337175,2022
4.1,260,6051,0,2,0,22,2129,0,0,4307,27128,121466,4638,153232,19,2363645,2022
4.2,438,7788,0,1,2,8,1506,0,0,2468,26167,123933,4638,154738,19,2390486,2022
4.3,425,8581,0,0,5,9,1405,0,0,1848,25724,125781,4638,156143,17,2418372,2022
4.4,268,13086,0,0,3,1,1235,0,0,1899,25060,127680,4638,157378,17,2456979,2022
4.5,311,16766,0,0,7,3,1415,0,0,1910,24565,129590,4638,158793,16,2498126,2022
4.6,322,19660,0,0,0,4,1323,0,4,1765,24123,131355,4638,160116,19,2538044,2022
4.7,824,20398,0,0,7,4,1576,0,4,1867,23832,133222,4638,161692,23,2582687,2022
4.8,1015,22609,1,0,5,5,1350,0,6,1996,23186,135218,4638,163042,29,2620524,2022
4.9,1006,23937,0,4,10,13,1351,0,0,1948,22589,137166,4638,164393,28,2656970,2022
4.10,914,25173,0,1,19,18,1184,0,0,1378,22395,138544,4638,165577,28,2687823,2022
4.11,994,22348,0,0,16,19,1272,0,0,1676,21991,140220,4638,166849,26,2715339,2022
4.12,1189,25141,0,0,22,9,1513,0,0,1678,21826,141898,4638,168362,26,2739650,2022
4.13,2573,25146,0,0,47,21,3020,0,0,2024,22822,143922,4638,171382,15,2769034,2022
4.14,3200,19872,0,0,22,19,3486,0,1,1430,24878,145352,4638,174868,16,2801989,2022
4.15,3590,19923,0,0,24,13,3896,0,0,2818,25956,148170,4638,178764,12,2825543,2022
4.16,3238,21582,0,0,29,11,3529,0,0,1600,27885,149770,4638,182293,12,2852563,2022
4.17,2417,19831,0,0,25,10,2742,3,0,1637,28987,151407,4641,185035,5,2876777,2022
4.18,3084,17332,0,0,20,5,3316,7,0,1912,30384,153319,4648,188351,5,2908653,2022
4.19,2494,16407,0,0,14,6,2761,7,1,2365,30773,155684,4655,191112,6,2937350,2022
4.20,2634,15861,0,0,8,4,2841,8,0,2183,31421,157869,4663,193953,2,3021806,2022
4.21,1931,15698,0,0,5,1,2133,11,0,2730,30813,160599,4674,196086,2,3061144,2022
4.22,2736,20634,0,0,8,2,2988,12,0,3127,30662,163726,4686,199074,2,3093236,2022
4.23,1401,19657,0,0,4,9,1580,39,0,2672,29531,166398,4725,200654,2,3131798,2022
4.24,2472,16983,0,0,3,3,2680,51,0,2982,29178,169380,4776,203334,2,3162375,2022
4.25,1661,15319,0,0,2,12,1923,52,0,2323,28726,171703,4828,205257,2,3200005,2022
4.26,1606,11956,0,0,33,8,1824,48,0,3728,26774,175431,4876,207081,0,3235941,2022
4.27,1292,9330,0,0,24,15,1503,47,0,2724,25506,178155,4923,208584,0,3290124,2022
4.28,5487,9545,0,0,7,7,5659,52,0,2796,28317,180951,4975,214243,0,3345519,2022
4.29,1249,8932,0,0,28,16,1424,47,0,3127,26567,184078,5022,215667,0,3394349,2022
4.30,788,7084,0,0,21,7,920,38,0,3447,24002,187525,5060,216587,0,3440464,2022
5.1,727,6606,0,0,23,2,865,32,0,4662,20173,192187,5092,217452,0,3476364,2022
5.2,274,5395,0,0,7,5,384,20,1,4271,16266,196458,5112,217836,1,3512074,2022
5.3,260,4722,0,0,12,4,362,16,0,2092,14520,198550,5128,218198,1,3546694,2022
5.4,261,4390,0,0,13,6,373,13,0,2125,12755,200675,5141,218571,0,3578073,2022
5.5,245,4024,0,0,13,1,374,12,0,1602,11515,202277,5153,218945,0,3605382,2022
5.6,253,3961,0,0,8,1,351,13,1,1878,9975,204155,5166,219296,1,3634625,2022
5.7,215,3760,0,0,21,3,329,8,0,1115,9181,205270,5174,219625,0,3662998,2022
5.8,322,3625,0,0,28,12,415,11,0,849,8736,206119,5185,220040,0,3692144,2022
5.9,234,2780,0,0,15,6,357,6,0,1019,8068,207138,5191,220397,0,3730326,2022
5.10,228,1259,0,0,10,10,324,7,0,817,7568,207955,5198,220721,0,3774376,2022
5.11,144,1305,0,0,3,2,237,5,1,571,7229,208526,5203,220958,1,3801166,2022
5.12,227,1869,0,0,11,3,331,2,0,614,6944,209140,5205,221289,1,3826863,2022
5.13,194,1487,0,0,4,2,276,1,0,866,6353,210006,5206,221565,0,3852915,2022
5.14,166,1203,0,0,1,0,239,3,0,448,6141,210454,5209,221804,0,3879227,2022
5.15,69,869,0,0,5,2,151,4,0,627,5661,211081,5213,221955,0,3899337,2022
5.16,77,746,0,0,15,2,175,1,0,476,5359,211557,5214,222130,0,3915237,2022
5.17,96,759,0,0,2,1,240,3,0,391,5205,211948,5217,222370,0,3932700,2022
5.18,82,637,0,0,1,1,212,1,0,394,5022,212342,5218,222582,0,3947706,2022
5.19,88,770,0,0,3,0,193,0,0,309,4906,212651,5218,222775,0,3960376,2022
5.20,84,784,0,0,9,2,201,1,0,391,4715,213042,5219,222976,0,3973934,2022
5.21,52,570,0,0,1,5,169,3,0,476,4405,213518,5222,223145,0,3991358,2022
